1111111111111111111111111111111111
1E0M00000000000C00000C0000M0000001
10100101001000111M1001000000010101
100000000000000100000C111110000001
1C00M11110000000100000000000001001
100001M000000000011011101000111001
100000000000001000000C101000000001
1111110010111010111100101011100001
1M00000010000010000000100000100001
1010010000C00000001000000000000001
1010011111111011111111111100111111
1C10000000001000001000000000000001
1000010000100010000011111111001101
1110000000100011100001M00C10000001
100001000010000C1M0000100010000001
11111000001M000M11110000111M001001
1000000000111101100000000001001001
1011100000100000000001M00000000001
1000000001000100000C01011001111001
10001001100000111000010C1000000M01
1000100000001100000001011010000001
1000101010010000100M11000010011101
1P0010001000C00010100000001M0000C1
1111111111111111111111111111111111