1111111111111111111111111111111111
1E0M00000000000C00000C0000M0000001
10100101001000011M1001000000010101
111001001M101010001001000000010101
1P0000000C00C00000000000000M0000C1
1111111111111111111111111111111111