1111
1001
1001
1C01
1001
1101
1001
1001
1E01
1001
1001
1001
1001
1001
1101
1001
1011
1001
1101
1001
10P1
1111